I2I2I2I2I2I2I2I2I2I2I2I2I2I2I2I2I2I2I2I2I2I2I2I2I1
I1L0L0K0K0K0K0L0L0A1J0J0J0J0J0H0L0L0K0K0K0K0L0L0I3
I1L0L0K0K0K0K0L0L0A1J0J0J0J0J0H0L0L0K0K0K0K0L0L0I3
I1L0L0K0K0K0K0L0L0A1J0J0J0J0J0H0L0L0K0K0K0K0L0L0I3
I1L0L0K0K0K0K0L0L0A1J0J0J0J0J0H0L0L0K0K0K0K0L0L0I3
I1L0L0K0K0K0K0L0L0A1J0J0J0J0J0H0L0L0K0K0K0K0L0L0I3
I1L0L0K0K0K0K0L0L0A1J0J0J0J0J0H0L0L0K0K0K0K0L0L0I3
I1L0L0K0K0K0K0L0L0A1J0J0J0J0J0H0L0L0K0K0K0K0L0L0I3
I1L0L0K0K0K0K0L0L0A1J0J0J0J0J0H0L0L0K0K0K0K0L0L0I3
I1L0L0K0K0K0K0L0L0A1J0J0J0J0J0H0L0L0K0K0K0K0L0L0I3
I1L0L0K0K0K0K0L0L0A1J0J0J0J0J0H0L0L0K0K0K0K0L0L0I3
I1L0L0K0K0K0K0L0L0A1J0J0J0J0J0H0L0L0K0K0K0K0L0L0I3
I1L0L0K0K0K0K0L0L0A1J0J0J0J0J0H0L0L0K0K0K0K0L0L0I3
I1L0L0K0K0K0K0L0L0A1J0J0J0J0J0H0L0L0K0K0K0K0L0L0I3
I1L0L0K0K0K0K0L0L0A1J0J0J0J0J0H0L0L0K0K0K0K0L0L0I3
I1L0L0K0K0K0K0L0L0A1J0J0J0J0J0H0L0L0K0K0K0K0L0L0I3
I1L0L0K0K0K0K0L0L0A1J0J0J0J0J0H0L0L0K0K0K0K0L0L0I3
I1L0L0K0K0K0K0L0L0A1J0J0J0J0J0H0L0L0K0K0K0K0L0L0I3
I1L0L0K0K0K0K0L0L0A1J0J0J0J0J0H0L0L0K0K0K0K0L0L0I3
I1L0L0K0K0K0K0L0L0A1J0J0J0J0J0H0L0L0K0K0K0K0L0L0I3
I1L0L0K0K0K0K0L0L0A1J0J0J0J0J0H0L0L0K0K0K0K0L0L0I3
I1L0L0K0K0K0K0L0L0A1J0J0J0J0J0H0L0L0K0K0K0K0L0L0I3
I1L0L0K0K0K0K0L0L0A1J0J0J0J0J0H0L0L0K0K0K0K0L0L0I3
I1L0L0K0K0K0K0L0L0A1J0J0J0J0J0H0L0L0K0K0K0K0L0L0I3
I1L0L0K0K0K0K0L0L0F0I0I0I0I0I0D0L0L0K0K0K0K0L0L0I3
I1L0L0K0K0K0K0L0L0G0I2I2I2I2I2E0L0L0K0K0K0K0L0L0I3
I1L0L0K0K0K0K0K0L0L0L0L0L0L0L0L0L0K0K0K0K0K0L0L0I3
I1L0L0K0K0K0K0K0K0K0K0K0K0K0K0K0K0K0K0K0K0K0L0L0I3
I1L0L0K0K0K0K0K0K0K0K0K0I0K0K0K0K0K0K0K0K0K0L0L0I3
I1L0L0K0K0K0K0K0K0K0K0K0K0K0K0K0K0K0K0K0K0K0L0L0I3
I1L0L0L0L0L0L0L0L0L0K0K0K0K0K0L0L0L0L0L0L0L0L0L0I3
I1C0A0A0A0A0A0A0A0B0L0K0K0K0L0C0A0A0A0A0A0A0A0B0I3
I1A1J0J0J0J0J0J0J0H0L0K0K0K0L0A1J0J0J0J0J0J0J0H0I3
I1A1J0J0J0J0J0J0J0H0L0K0K0K0L0A1J0J0J0J0J0J0J0H0I3
I1A1J0J0J0J0J0J0J0H0L0K0K0K0L0A1J0J0J0J0J0J0J0H0I3
I1A1J0J0J0J0J0J0J0H0L0K0K0K0L0A1J0J0J0J0J0J0J0H0I3
I1A1J0J0J0J0J0J0J0H0L0K0K0K0L0A1J0J0J0J0J0J0J0H0I3
I1A1J0J0J0J0J0J0J0H0L0K0K0K0L0A1J0J0J0J0J0J0J0H0I3
I1F0J0J0I0I0I0I0I0D0L0K0K0K0L0F0I0I0I0I0I0J0J0D0I3
I1G0J0J0I2I2I2I2I2E0L0K0K0K0L0G0I2I2I2I2I2J0J0E0I3
I1L0L0L0L0L0L0L0L0L0L0K0K0K0L0L0L0L0L0L0L0L0L0L0I3
I1L0K0K0K0K0K0K0K0K0K0K0K0K0K0K0K0K0K0K0K0K0K0L0I3
I1L0K0K0K0K0K0K0K0K0K0K0K0K0K0K0K0K0K0K0K0K0K0L0I3
I1L0K0K0K0K0K0K0K0K0K0K0K0K0K0K0K0K0K0K0K0K0K0L0I3
I1L0K0K0K0K0K0K0K0K0K0K0K0K0K0K0K0K0K0K0K0K0K0L0I3
I1L0K0K0K0K0K0K0K0K0K0K0K0K0K0K0K0K0K0K0K0K0K0L0I3
I1L0K0K0K0C0A0A0A0A0A0A0A0A0A0A0A0A0A0B0K0K0K0L0I3
I1L0K0K0K0A1J0M0M0M0M0M0M0M0M0M0M0M0J0H0K0K0K0L0I3
I1L0K0K0K0A1J0M0M0M0M0M0M0M0M0M0M0M0J0H0K0K0K0L0I3
I1L0K0K0K0A1J0M0M0M0M0M0M0M0M0M0M0M0J0H0K0K0K0L0I3
I1L0K0K0K0A1J0M0M0M0M0M0M0M0M0M0M0M0J0H0K0K0K0L0I3
I1L0K0K0K0A1J0M0M0M0M0M0M0M0M0M0M0M0J0H0K0K0K0L0I3
I1L0K0K0K0A1J0C0A0A0B0M0M0M0C0A0A0C1J0H0K0K0K0L0I3
I1L0K0K0K0A1J0A1J0J0H0M0M0M0A1J0J0A1J0H0K0K0K0L0I3
I1L0K0K0K0A1J0A1J0J0H0M0M0M0A1J0J0A1J0H0K0K0K0L0I3
I1L0K0K0K0A1J0A1J0J0H0M0M0M0A1J0J0A1J0H0K0K0K0L0I3
I1L0K0K0K0A1J0A1J0J0H0M0M0M0A1J0J0A1J0H0K0K0K0L0I3
I1L0K0K0K0A1J0A1J0J0H0M0M0M0A1J0J0A1J0H0K0K0K0L0I3
I1L0K0K0K0A1J0A1J0J0H0M0M0M0A1J0J0A1J0H0K0K0K0L0I3
I1L0K0K0K0A1J0A1J0J0H0M0M0M0A1J0J0A1J0H0K0K0K0L0I3
I1L0K0K0K0A1J0A1J0J0H0M0M0M0A1J0J0A1J0H0K0K0K0L0I3
I1L0K0K0K0A1J0A1J0J0H0M0M0M0A1J0J0A1J0H0K0K0K0L0I3
I1L0K0K0K0A1J0A1J0J0H0M0M0M0A1J0J0A1J0H0K0K0K0L0I3
I1L0K0K0K0F0I0I0I0I0D0M0M0M0F0I0I0I0I0D0K0K0K0L0I3
I1L0K0K0K0G0I2I2I2I2E0M0M0M0G0I2I2I2I2E0K0K0K0L0I3
I1L0K0K0K0L0L0L0L0L0K0K0K0K0K0L0L0L0L0L0K0K0K0L0I3
I1L0K0K0K0K0K0K0K0K0K0K0K0K0K0K0K0K0K0K0K0K0K0L0I3
I1L0K0K0K0K0K0K0K0K0K0K0K0K0K0K0K0K0K0K0K0K0K0L0I3
I0I0I0I0I0I0I0I0I0I0I0I0I0I0I0I0I0I0I0I0I0I0I0I0I0